11111111111111111111
1P000000011111111111
1000000C1111000000E1
11111000110000000001
1000100110000000C001
10C00000C00000111111
11111111111111111111
