1111111111111
10000C00000C1
1000010000001
1000010000001
100C011000001
1000011100001
1000001000C01
10000C1100001
111000111001
1E101111111P1
1111111111111
