1111111111111
10000C00000C1
1000010000001
1000010000001
100C011000001
1000011100001
1000001000C01
10000C1100001
1110001110001
1E10111111101
1111111111111
